east,north
01,03
43,43,43,43,10,8,11,8,8,12,
5,48,49,41,13,14,1,2,3,4,
43,51,5,43,25,26,27,5,6,4,
5,53,43,5,43,43,43,19,9,4,
43,51,5,43,48,49,50,22,23,15,
5,53,5,43,51,5,53,25,17,18,
5,51,5,5,53,43,51,43,38,5,
43,54,41,41,56,43,51,5,38,43,
43,43,43,5,43,43,54,55,56,5,
5,43,43,43,43,43,43,43,43,43