west
02
43,52,43,52,43,52,43,52,52,43,
52,5,43,43,43,43,5,43,43,52,
43,19,20,8,20,12,52,43,5,43,
52,22,1,2,2,46,29,30,43,52,
41,47,18,52,10,12,38,38,52,43,
52,43,48,41,47,18,38,39,43,52,
43,43,51,43,52,43,53,43,52,43,
52,43,54,55,41,41,56,52,5,52,
43,5,43,43,43,43,43,43,52,43,
52,43,52,43,52,43,5,43,43,52