south
02
43,43,43,43,43,5,43,43,43,43,
5,52,5,43,43,52,43,5,43,43,
43,43,5,43,43,5,43,43,43,5,
5,52,43,43,5,43,19,20,21,43,
43,5,5,43,43,43,22,23,24,43,
43,52,5,5,43,5,25,17,27,5,
52,5,52,43,5,43,43,38,43,43,
43,43,43,52,5,43,5,38,52,5,
5,5,43,43,43,43,43,38,52,52,
43,43,43,5,43,43,5,38,52,43